,Unnamed: 0,name,screen_name,created_at,followers_count,friends_count,statuses_count,retweets_count,total_likes,popularity_score,reach_score
0,0,Jeffrey Gettleman,gettleman,2011-05-25 17:49:42,25703,37,3771,146473,1047,147520,25666
1,1,A24 Media,a24media,2009-03-25 11:29:33,31286,3059,16869,221,140,361,28227
2,2,Scapegoat,AndiMakinana,2009-09-06 10:53:07,101255,2838,142230,10655,1724,12379,98417
3,3,Africa Check,AfricaCheck,2012-07-03 11:34:29,68061,4592,27324,453,401,854,63469
4,4,James Copnall,JamesCopnall,2011-10-30 17:32:39,21962,5050,19439,125908,146,126054,16912
5,5,Online Africa,oafrica,2009-08-13 17:13:41,31294,2877,6864,1474,74,1548,28417
6,6,Patrick Ngowi,PatrickNgowi,2012-12-12 11:35:01,22798,179,1638,7549,196,7745,22619
7,7,SEO Expert Vancouver,stateafrica,2017-06-12 09:53:56,8,0,1,0,1,1,8
8,8,Mohammed Adow,Moadow,2009-04-14 08:10:59,50984,1732,21549,9125,175,9300,49252
9,9,Brendan Boyle,BrendanSAfrica,2009-01-23 17:02:49,28467,366,3892,2911,451,3362,28101
10,10,City of Tshwane,CityTshwane,2010-05-28 08:34:35,439375,2927,81200,4062,1600,5662,436448
11,11,VISI Magazine,VISI_Mag,2009-08-31 14:45:27,52894,1818,16890,161,460,621,51076
12,12,This Is Africa,ThisIsAfricaTIA,2009-07-01 14:19:28,46775,2138,23988,4309,532,4841,44637
13,13,Sarah Carter,sarzss,2010-11-11 08:57:03,11927,894,2166,13445,305,13750,11033
14,14,The EIU Africa team,TheEIU_Africa,2010-02-17 16:58:52,24864,294,2523,596,138,734,24570
15,15,Investing In Africa,InvestInAfrica,2008-09-15 20:52:05,49695,172,2814,385,300,685,49523
16,16,Barry Malone,malonebarry,2009-01-08 04:27:43,28428,2988,35262,52122,638,52760,25440
17,17,ArtSouthAfrica,ArtSouthAfrica,2016-06-01 09:24:54,117,132,23,334,8,342,-15
18,18,Kahn Morbee,KahnMorbee,2009-01-29 16:18:58,17443,425,4993,1283,520,1803,17018
19,19,Jamal Osman,JamalMOsman,2010-10-31 18:47:36,93957,659,13508,49895,1556,51451,93298
20,20,iamsuede™,iamsuede,2009-03-23 05:05:51,18238,2256,88730,12340,223,12563,15982
21,21,Mike Stopforth,mikestopforth,2007-03-07 17:29:47,21365,813,42969,123138,198,123336,20552
22,22,Equal Education,equal_education,2010-06-19 10:06:48,62294,748,26786,1033,643,1676,61546
23,23,Tristan McConnell,t_mcconnell,2011-11-30 10:13:50,18501,940,15627,7064,771,7835,17561
24,24,Kate Forbes,forbeesta,2009-01-11 12:23:42,19996,3603,9575,202096,385,202481,16393
25,25,Jax Panik,jaxpanik,2007-12-31 01:15:45,7489,15,15410,2880,105,2985,7474
26,26,audisouthafrica,audisouthafrica,2010-08-23 13:12:27,215385,1155,22994,490,3556,4046,214230
27,27,ONE in Africa,ONEinAfrica,2011-09-19 14:08:39,232811,89603,7579,3141,1442,4583,143208
28,28,Hamza Mohamed,Hamza_Africa,2010-01-27 04:41:45,98720,220,17748,11670,1164,12834,98500
29,29,Rebecca Enonchong,africatechie,2010-01-23 16:33:53,106153,1644,101297,21059,2252,23311,104509
30,30,marais,cx73,2010-05-10 19:42:53,70751,49688,4986,965,1045,2010,21063
31,31,George Ayittey,ayittey,2009-04-08 23:27:30,17114,151,12766,357,906,1263,16963
32,32,Mercedes-Benz SA,MercedesBenz_SA,2010-04-15 09:31:16,249919,2415,15755,1679,576,2255,247504
33,33,Africa Gathering,africagathering,2009-01-20 10:01:21,48964,653,8771,90636,42,90678,48311
34,34,OkayAfrica,OkayAfrica,2009-11-23 23:51:39,105229,1919,45452,1127,2129,3256,103310
35,35,Mary Harper,mary_harper,2009-06-04 16:43:39,58228,1979,7187,112859,310,113169,56249
36,36,Save the Rhino,savetherhino,2009-05-21 11:55:15,80345,983,35782,1318,3228,4546,79362
37,37,TechCentral,TechCentral,2009-02-02 18:14:26,81638,1905,18369,100,121,221,79733
38,38,GautengGov,GautengProvince,2011-07-13 16:00:41,217178,3122,33459,17558,3500,21058,214056
39,39,Abdi Aynte,Aynte,2009-04-27 07:37:20,192544,1346,14514,10783,1070,11853,191198
40,40,Daniel Howden,daniel_howden,2009-11-03 12:04:07,24706,3706,8767,60318,365,60683,21000
41,41,Ranger Diaries,rangerdiaries,2010-09-28 14:56:14,20449,4614,3906,747,1606,2353,15835
42,42,The Star,TheStar_news,2011-03-16 08:45:41,191382,405,48599,577,67,644,190977
43,43,James Schneider,schneiderhome,2010-11-12 12:22:14,26434,1008,32731,182238,3531,185769,25426
44,44,The Africa Report,TheAfricaReport,2008-12-10 11:24:06,165765,1144,15884,282,348,630,164621
45,45,City of Joburg,CityofJoburgZA,2012-03-07 07:05:58,1002707,61972,265258,2998,351,3349,940735
46,46,Think Africa Press,ThinkAfricaFeed,2010-12-21 16:12:50,48253,1114,16251,614,124,738,47139
47,47,Africa The Good News,AfricaGoodNews,2009-05-13 07:18:36,50088,757,11100,67855,6,67861,49331
48,48,will ross,willintune,2010-11-24 17:37:13,18633,1489,8550,7338,434,7772,17144
49,49,CNBC Africa,cnbcafrica,2009-07-16 13:52:16,240600,657,91475,177,260,437,239943
50,50,HowWeMadeItInAfrica,MadeItInAfrica,2010-03-29 19:48:33,105651,391,30378,386,610,996,105260
51,51,Africa Research Inst,AfricaResearch,2011-01-11 14:04:23,88501,1940,23204,4143,197,4340,86561
52,52,FoodBlog Cape Town,FoodBlogCT,2010-01-30 12:59:28,84528,25646,137304,21,86,107,58882
53,53,Mbuyiseni Ndlozi,MbuyiseniNdlozi,2012-01-04 14:28:42,1077384,5473,35966,59099,78987,138086,1071911
54,54,AfricaProgressPanel,africaprogress,2011-05-03 15:59:50,56242,3166,10665,929,745,1674,53076
55,55,IFC Africa,IFCAfrica,2010-05-04 08:36:50,127360,1545,8895,865,496,1361,125815
56,56,Henley Africa,HenleyAfrica,2011-10-17 06:39:28,143190,74076,38395,169,239,408,69114
57,57,Geoffrey York,geoffreyyork,2009-05-27 19:30:42,285559,10834,53774,9890,870,10760,274725
58,58,#Entrepreneurship #Solutions,Entrepreneur_SA,2017-03-02 15:05:55,130,141,117,614,79,693,-11
59,59,Forbes Africa,forbesafrica,2011-04-18 15:18:58,215948,128,9294,253,479,732,215820
60,60,IEC South Africa,IECSouthAfrica,2011-02-04 12:44:49,220882,11,23704,554,429,983,220871
61,61,Arthur Goldstuck,art2gee,2008-09-08 13:51:01,59202,3347,13353,1507,190,1697,55855
62,62,Jendayi E Frazer,JendayiFrazer,2011-04-11 00:13:17,29951,480,3118,838475,10,838485,29471
63,63,Peter Greste,PeterGreste,2009-08-09 09:22:50,51839,987,14758,8280,1118,9398,50852
64,64,Disaster Operations,NDOCKenya,2011-04-28 10:43:39,151976,561,3243,11948,171,12119,151415
65,65,Mo Ibrahim Foundation,Mo_IbrahimFdn,2011-03-24 17:00:56,114505,1641,11275,676,1154,1830,112864
66,66,Parliament of RSA,ParliamentofRSA,2011-12-06 07:40:44,673298,2205,27250,164,275,439,671093
67,67,Sandton City,SandtonCity,2009-06-18 19:15:10,56866,985,14684,43,245,288,55881
68,68,African Union,_AfricanUnion,2010-05-20 06:48:25,541494,186,9266,2737,3252,5989,541308
69,69,Gert-Johan Coetzee,gertjohan,2010-03-03 20:48:49,49249,305,6476,1458,1782,3240,48944
70,70,SmithInAfrica,SmithInAfrica,2015-10-19 23:34:14,69,0,1,1,0,1,69
71,71,Ray Hartley,hartleyr,2007-08-21 10:30:55,35227,455,21728,13195,260,13455,34772
72,72,Live Amp,liveamp,2009-09-22 11:14:33,938002,1618,50980,705,5650,6355,936384
73,73,SamsungSA,SamsungSA,2010-03-29 09:53:12,572282,269,23587,211,1653,1864,572013
74,74,Bob Skinstad,BobSkinstad,2009-03-18 14:36:58,105678,2989,27791,12209,103,12312,102689
75,75,CAMFED - Campaign for Female Education,Camfed,2009-03-09 23:03:10,183462,25600,15681,12419,1793,14212,157862
76,76,Andrew H,BBCAndrewH,2018-04-27 05:48:52,7,0,6,0,1,1,7
77,77,Euphonik™♛,euphonik,2009-02-18 18:36:47,1755243,65,4525,5770,23280,29050,1755178
78,78,Ulrich Janse van Vuuren,UlrichJvV,2009-10-10 07:33:26,1042378,530311,19994,12200,21197,33397,512067
79,79,Cricket South Africa,OfficialCSA,2009-06-09 14:27:09,1160197,1998,88552,7845,12248,20093,1158199
80,80,MTV Base Africa,MTVBaseAfrica,2009-03-23 05:28:57,1415964,109,56044,23724,4265,27989,1415855
81,81,Computicket,Computicket,2010-01-12 18:12:39,200264,1224,45129,283,83,366,199040
82,82,Loyiso Gola,loyisogola,2009-04-21 12:53:28,1085186,3947,5688,2312,3544,5856,1081239
83,83,5FM,5FM,2008-10-18 15:22:23,1164334,411,62841,521,2743,3264,1163923
84,84,Mail & Guardian,mailandguardian,2008-10-14 07:56:54,1060225,478,144302,2605,306,2911,1059747
85,85,Helen Zille,helenzille,2009-02-10 16:01:34,1443294,2303,72335,7816,5451,13267,1440991
86,86,Julius Sello Malema,Julius_S_Malema,2010-02-24 14:58:49,3129102,652,37215,67316,81060,148376,3128450
87,87,News24,News24,2008-05-08 07:45:58,3577478,631,322873,1434,5220,6654,3576847
88,88,jdwtweet,SAPresident,2019-03-04 09:59:11,18,14,19,851,0,851,4
89,89,Gareth Cliff,GarethCliff,2008-12-08 13:20:23,1974534,356,31626,2855,5400,8255,1974178
90,90,Trevor Noah,Trevornoah,2009-06-11 07:03:48,10807725,325,11186,2927518,776397,3703915,10807400
